####################
#..................#
#..................#
#...########.......#
#...#..............#
#...#..............#
#...#...#########..#
#...#..............#
#...#..............#
#...#######..#######
#...#..............#
#...#..............#
#...#....#.........#
#...#....########..#
#...#....#.........#
#.###....#.........#
#...#....#.........#
###.#....#..########
@...#..............$
####################
