##################################################
#................................................#
#........................####..........#.........#
#...#############....#####.............#.........#
#...#....................##..#####.....####......#
#...#....................#................#......#
#...#...#########........#................#......#
#...#....................#.............###########
#...#....................#.........#####.........#
#...#######..#############..########............##
#...#....................#.......................#
##.###................####.......................#
#........#............#.........##########.......#
#........########.....#.........#.............#..#
#...#....#............#.........#............#...#
#.###....#............#.........#..........##....#
#...#....#............#.........#......#####.....#
###.#....#..######....#..................#......##
>...#.................#..................#.......<
##################################################
