XXXXXXXXXX
X........$
X........X
X........X
@........X
XXXXXXXXXX
