##########
#........#
#...#....#
#...#....#
@...#....$
##########
