##########
#........$
#........#
#........#
@........#
##########
