################################################################################
#..............................................................................#
#........................####..........#.......................................#
#...#############....#####.............#.......................................#
#...#....................##..#####.....####....................................#
#...#....................#................#....................................#
#...#...#########........#................#....................................#
#...#....................#.............#########..............................##
#...#....................#.........#####.......................................#
#...#######..#############..########..........................................##
#...#....................#.....................................................#
##.###................####.....................................................#
#........#............#.........##########.....................................#
#........########.....#.........#.............#................................#
#...#....#............#.........#............#.................................#
#.###....#............#.........#..........##..................................#
#...#....#............#.........#......#####...................................#
###.#....#..######....#..................#....................................##
#>...#.................#..................#...................................<#
###.#....#..######....#..................#....................................##
###.#....#..######....#..................#....................................##
###.#....#..######....#..................#....................................##
###.#....#..######....#..................#....................................##
###.#....#..######....#..................#....................................##
################################################################################
