####################
#..................#
#..................#
#...########.......#
#...#..............#
#...#..............#
#...#..##########..#
#...#..............#
#...#..............#
#...#######..#######
#...#..............#
#...#..............#
#...#....#.........#
#...#....#.........#
#...#....#.........#
#...#....#.........#
#...#....#.........#
#...#....###########
@...#..............$
####################
